# UNIT 4
# P. 99 i 형용사
いい(よい) - 좋다
わるい - 나쁘다
あたらしい - 새롭다
ふるい - 낡다
うれしい - 기쁘다
かなしい - 슬프다
おいしい - 맛있다
まずい - 맛이 없다
おおい - 많다
すくない - 적다
かるい - 가볍다
おもい - 무겁다
つよい - 강하다
よわい - 약하다
とおい - 멀다
ちかい - 가깝다
おもしろい - 재미있다
つまらない - 재미없다, 지루하다
ながい - 길다
みじかい - 짧다
はやい - 빠르다
おそい - 늦다
ひろい - 넓다
せまい - 좁다
おおきい - 크다
ちいさい - 작다
やさ(優)しい - 상냥하다, 온순하다
やさ(易)しい - 쉽다
むずかしい - 어렵다
たか(高)い - 높다, 키가 크다
たか(高)い - 비싸다
ひくい - 낮다, 키가 작다
やすい - 싸다, 저렴하다
あつ(熱)い - 뜨겁다
つめたい - 차다, 차갑다
あつ(暑)い - 덥다
さむい - 춥다
しょっぱい(しおからい) - 짜다
あまい - 달다
すっぱい - 시다
からい - 맵다
にがい - 쓰다
あかい - 빨갛다
あおい - 파랗다
くろい - 검다
きいろい - 노랗다
しろい - 하얗다
すずしい - 시원하다
むしあつい - 무덥다, 후덥지근하다
あたたかい - 따뜻하다
かわいい - 귀엽다, 예쁘다
いそがしい - 바쁘다
たのしい - 즐겁다
こわい - 무섭다
つらい - 괴롭다
すごい - 굉장하다, 엄청나다
すばらしい - 멋지다, 훌륭하다
うるさい - 시끄럽다
